30 30 tileset 80
0 0 0 0 0 0 0 0 0 0 0 0 0 0 0 0 0 0 0 0 0 0 0 0 0 0 0 0 0 0 
0 0 0 0 0 0 0 0 0 0 0 0 0 0 0 0 0 0 0 0 0 0 0 0 0 0 0 0 0 0 
0 0 0 0 0 0 0 0 0 0 0 0 0 0 0 0 0 0 0 0 0 0 0 0 0 0 0 0 0 0 
0 0 0 0 0 0 0 0 0 0 0 0 9 19 19 19 19 19 19 19 19 69 0 0 0 0 0 0 0 0 
0 0 0 0 0 0 0 0 0 0 0 0 29 22 22 22 22 22 22 22 22 30 0 0 0 0 0 0 0 0 
0 0 0 0 0 0 0 0 0 0 0 0 29 22 22 22 22 22 22 22 22 30 0 0 0 0 0 0 0 0 
0 0 0 0 0 0 0 0 0 0 0 0 73 25 25 25 25 25 25 25 25 14 0 0 0 0 0 0 0 0 
0 0 0 0 0 0 0 0 0 0 0 0 0 0 0 0 0 0 0 0 0 0 0 0 0 0 0 0 0 0 
0 0 0 0 0 0 0 0 0 0 0 0 0 0 0 0 0 0 0 0 0 0 0 0 0 0 0 0 37 0 
0 0 0 0 0 0 0 0 0 0 0 0 0 0 0 0 0 0 0 0 0 0 0 0 0 0 0 0 38 0 
0 34 35 35 35 35 35 36 0 0 0 0 0 0 0 0 0 0 0 0 0 0 0 0 0 0 0 0 38 0 
0 0 0 0 0 0 0 0 0 0 0 0 0 0 0 0 0 0 0 0 0 0 0 0 0 0 0 0 38 0 
0 0 0 0 0 0 0 0 0 0 0 0 0 0 0 0 0 0 0 0 0 0 0 0 0 0 0 0 38 0 
0 0 0 0 0 0 0 0 0 0 0 0 0 0 0 0 0 0 0 0 0 0 0 0 0 0 0 0 38 0 
0 34 35 35 35 35 35 36 0 0 0 0 0 0 0 0 0 0 0 0 0 0 0 34 35 35 35 35 40 0 
0 0 0 0 0 0 0 0 0 0 0 0 0 0 0 0 0 0 0 0 0 0 0 0 0 0 0 0 0 0 
0 0 0 0 0 0 0 0 0 0 0 0 9 19 19 19 19 19 19 19 10 0 0 0 0 0 0 0 0 0 
0 0 0 0 0 0 0 0 0 0 0 0 28 22 22 22 22 22 22 22 12 0 0 0 0 0 0 0 0 0 
0 0 0 0 0 0 0 0 0 0 0 0 28 22 22 22 22 22 22 22 12 0 0 0 0 0 0 0 0 0 
0 0 0 0 0 0 0 0 0 0 0 0 28 22 22 22 22 22 22 22 12 0 0 0 0 0 0 0 0 0 
19 19 19 19 19 19 19 19 19 19 19 19 76 22 22 22 22 22 22 22 77 19 19 19 19 19 19 19 19 19 
22 22 22 22 22 22 22 22 22 22 22 22 22 22 22 22 22 22 22 22 22 22 22 22 22 22 22 22 22 22 
22 22 22 22 22 22 22 22 22 22 22 22 22 22 22 22 22 22 22 22 22 22 22 22 22 22 22 22 22 22 
22 22 22 22 22 22 22 22 22 22 22 22 22 22 22 22 22 22 22 22 22 22 22 22 22 22 22 22 22 22 
22 22 22 22 22 22 22 22 22 22 22 22 22 22 22 22 22 22 22 22 22 22 22 22 22 22 22 22 22 22 
22 22 22 22 22 22 22 22 22 22 22 22 22 22 22 22 22 22 22 22 22 22 22 22 22 22 22 22 22 22 
22 22 22 22 22 22 22 22 22 22 22 22 22 22 22 22 22 22 22 22 22 22 22 22 22 22 22 22 22 22 
22 22 22 22 22 22 22 22 22 22 22 22 22 22 22 22 22 22 22 22 22 22 22 22 22 22 22 22 22 22 
22 22 22 22 22 22 22 22 22 22 22 22 22 22 22 22 22 22 22 22 22 22 22 22 22 22 22 22 22 22 
22 22 22 22 22 22 22 22 22 22 22 22 22 22 22 22 22 22 22 22 22 22 22 22 22 22 22 22 22 22
1 1 16 16
18 1 16 16
35 1 16 16
52 1 16 16
69 1 16 16
86 1 16 16
103 1 16 16
120 1 16 16
137 1 16 16
154 1 16 16
171 1 16 16
188 1 16 16
205 1 16 16
222 1 16 16
239 1 16 16
256 1 16 16
1 18 16 16
18 18 16 16
35 18 16 16
52 18 16 16
69 18 16 16
86 18 16 16
103 18 16 16
120 18 16 16
137 18 16 16
154 18 16 16
171 18 16 16
188 18 16 16
205 18 16 16
222 18 16 16
239 18 16 16
256 18 16 16
1 35 16 16
18 35 16 16
35 35 16 16
52 35 16 16
69 35 16 16
86 35 16 16
103 35 16 16
120 35 16 16
137 35 16 16
154 35 16 16
171 35 16 16
188 35 16 16
205 35 16 16
222 35 16 16
239 35 16 16
256 35 16 16
1 52 16 16
18 52 16 16
35 52 16 16
52 52 16 16
69 52 16 16
86 52 16 16
103 52 16 16
120 52 16 16
137 52 16 16
154 52 16 16
171 52 16 16
188 52 16 16
205 52 16 16
222 52 16 16
239 52 16 16
256 52 16 16
1 69 16 16
18 69 16 16
35 69 16 16
52 69 16 16
69 69 16 16
86 69 16 16
103 69 16 16
120 69 16 16
137 69 16 16
154 69 16 16
171 69 16 16
188 69 16 16
205 69 16 16
222 69 16 16
239 69 16 16
256 69 16 16